NO ./wall_1.png
SO ./wall_2.png
WE ./wall_3.png
EA ./wall_4.png

F 125,158,124
C 51,235,255

111111111111111
1N0S1W0011E00P1
100010000D00001
100010000111111
11D110000000001
1000000000000W1
111111111111111
