1111111
1N01001
1001001
1001001
1011001
1000001
1111111
