11111111
10001001
10001001
10001001
10011001
100000N1
11111111
