11111111
10001001
10N01001
10001001
10011001
10000001
11111111
