NO ./wall_1.png
SO ./wall_2.png
EA ./wall_4.png
WE ./wall_3.png

F 125,158,124
C 51,235,255

1111111111111111
1000100000000001
1000100000000001
1000100001100001
11D1100000000001
10000000000000N1
1111111111111111
