NO ./wall_1.png
SO ./wall_2.png
WE ./wall_3.png
EA ./wall_4.png

F 125,158,124
C 51,235,255

11111111
10001001
10001001
100N1001
10011001
10000001
11111111
