1111111
1001001
10N1001
1001001
1011001
1000001
1111111
