NO ./wall_1.png
SO ./wall_2.png
WE ./wall_3.png
EA ./wall_4.png

F 125,158,124
C 51,235,255

1111111111111111
1N00100000000001
1000100000000001
1000100000000001
11P1100000000001
1000000000000001
1111111111111111
