NO ./tex3.png
SO ./tex4.png
EA ./tex6.png
WE ./tex5.png

F 125,158,124
C 51,235,255

111111111111111
10W01V0011O00M1
100010000D00001
100010000111111
11D110000000001
1000000000000M1
111111111111111
