NO ./wall_1.png
SO ./wall_2.png
WE ./wall_3.png
EA ./wall_4.png

F 125,158,124
C 51,235,255

111111111
1N0010001
100010001
100S10001
100010001
100011101
100011101
100011101
100011101
11D111101
100011101
100011101
1000000E1
111111111
