NO ./sprites/tex3.png
SO ./sprites/no_square_sprite.png
EA ./sprites/tex6.png
WE ./sprites/tex5.png

F 125,158,124
C 51,235,255

111111111111111111111111111111111111111111111111111111111111111111
100000000000000000000000000000000000000000000000000001111111111111
10O00011111111111111010S011111111011111110000010011001111000000011
10000000000000D000000100010000100000000010001110111101111000000011
100001000000111001001101110000100011100010001000001001111000000011
10000100001110000100000D000100100000100010101101111001111000000011
100001000010000001111111000100111110110110100000110001111000000011
1000010000100000000000000001000001001101001110000D000DDDD000V00011
100001000011111000000000100100M001000D0000100001110001111000000011
100000000000010000111111101110000100010110100001000001111000000011
10100000M000010000D00000100001000100010100100001000011111000000011
101000000000010000111000110111110111010100100000000111111000000011
101101000000000000001000000000000000010000100010000101111000000011
100001000001000000001000000001000000010100000010010001111111111111
111111111111111111111111111111111111111111111111111111111111111111