NO ./sprites/tex3.png
SO ./sprites/tex4.png
EA ./sprites/tex6.png
WE ./sprites/tex5.png

F 125,158,124
C 51,235,255

11111
1N001M
10001M
10101
11111