NO ./sprites/tex3.png
SO ./sprites/tex4.png
EA ./sprites/tex6.png
WE ./sprites/tex5.png

F 125,158,124
C 51,235,255

1111111111111111
1N00100000000001
1000100000000001
1000100001100001
11D1100000000001
1000000000000001
1111111111111111
