NO ./sprites/tex3.png
SO ./sprites/tex4.png
EA ./sprites/tex6.png
WE ./sprites/tex5.png

F 125,158,124
C 51,235,255

1111111111111111111111111
1N00000000110000000000001
1011000001110000000000001
100100000000000000000000111111111
111111111011000001110000000000001
100000000011000001110111111111111
11110111111111011100000010001
11110111111111011101010000001
11000000110101011100000010001
10000000000000001100000010001
10000000000000001101010010001
11000001110101011111011110001
11110111 1110101 101111010001
11111111 1111111 111111111111
