SO ./sprites/tex4.png
EA ./sprites/tex6.png
WE ./sprites/tex5.png
NO ./sprites/tex3.png

F 125,158,124
C 51,235,255

111111111111111
10W01V0011O0001
100010000D00001
100010000111111
11D110000000001
1000000000000M1
111111111111111
