EA ./sprites/tex6.png
NO ./sprites/tex5.png
WE ./sprites/tex4.png

F 125,158,124
C 51,235,255

111111
100101
101001
1100E1
111111
