NO ./sprites/tex4.png
SO ./sprites/tex6.png
EA ./sprites/tex5.png
WE ./sprites/tex3.png

F 300,158,124
C 51,235,255

111111
100101
101001
1100W1
111111
